문장: 명령어 하나
;(세미콜론): 문장이 끝났다는것을 알리기위한 기호
구문(or블록): {}(중괄호)로 묶여있는 문장들의 단위 or 지역변수의 생존범위
.(점): 오른쪽의 것은 왼쪽의 것에 포함되어있는 것

변수: 데이터를 가지고 있는것
-int: 정수
-float: 실수
-string: 문자열
-bool: 참 또는 거짓
함수: 필요할때 불러쓰는 구문
매개변수: 함수 외부에서 값을 받아와서 문장을 실행하기 위한 변수
리턴: 함수의 값을 호출
전역변수: 함수 밖에서도 사용 가능한 변수
지역변수: 함수 안에서만 사용 가능한 변수

class: 
public: 클래스 바깥에서 사용할 수 있도록 해주는 것
private: 클래스 안에서만 사용할 수 있도록 해주는 것

if: 괄호안의 문장이 참이라면 실행
ㄴelse: 괄호안의 문장이 거짓이라면 실행
ㄴelse if: if의 괄호 안의 문장이 거짓이고 else if의 괄호 안의 문장이 참일때 실행
switch: 괄호 안의 것의 상태에 따라 다르게 실행
for: 구문 안의 문장들을 일정 횟수만큼 반복해주는 것
while: 특정 조건을 만족하지 않을때까지 구문안의 문장들을 반복해주는 것
break: 구문을 나감
continue: 한 구문만 나간뒤 그 구문을 처음부터 다시실행

=: 오른쪽의 것을 왼쪽의 것에 대입
!: 반대의 것(참이라면 거짓, 거짓이라면 참)
+=, -=, *=, /=: 왼쪽의 것에서 오른쪽의것 만큼 =앞의 기호에따라 연산후 대입
==:왼쪽의 것과 오른쪽의 것이 같다는 뜻
!=: 왼쪽의 것과 오른쪽의 것이 다르다는 뜻
||: 왼쪽이 참 또는 오른쪽이 참
&&: 왼쪽과 오른쪽이 모두 참

Console.WirteLine: 괄호 안의 것을 출력
Console.ReadLine: 콘솔에서 입력하면 입력값을 괄호 안에 대입

[디버깅]
F9: 브레이킹 포인트
F11: 변수의 값을 볼 수 있음
F12: 함수의 원본을 볼 수 있음

[게임시스템 기획]
퀘스트: 보상을 받기위한 의뢰
인벤토리: 소지하고있는 물품, 장비 등을 볼수있는 창
쿨타임: 재사용 가능하기까지의 남은 시간

[유니티]
게임오브젝트(GameObject): 게임 내의 오브젝트
하이어라키(Hierarchy): 게임오브젝트들을 나열해논 창
-메인카메라(Main Camera): 가장 기본이 되는 카메라
인스펙터(Inspector): 한 오브젝트의 컴포넌트들을 볼 수 있는 창
씬(Scene): 오브젝트들을 이용해 만든 하나의 시뮬레이션
에셋(Assets): 하나의 게임 그 자체
에셋스토어(Asset Store): 에셋을 다운로드 받는 곳
콘솔(Console): 씬에서 주의사항이나 오류들을 알려주고 원하는 글을 출력할 수 있는 창
컴포넌트(Component): 오브젝트의 상태나 기능을 조절할 수 있는 것
-트랜스폼(Transform): 오브젝트의 위치, 방향, 크기를 조절할 수 있는 컴포넌트
ㄴ포지션(Position): 오브젝트의 위치를 조절할 수 있는 것
ㄴ로테이션(Rotation): 오브젝트의 방향을 조절할 수 있는 것
ㄴ스케일(Scale): 오브젝트의 크기를 조절할 수 있는 것
-스프라이트렌더러(Sprite Renderer): 오브젝트의 생김새를 조절할 수 있는 컴포넌트
ㄴ스프라이트(Sprite): 오브젝트 이미지
ㄴ머트리얼(Material): 스프라이트의 재질같은 것

